111111
10C0E1
100001
10C001
1000C1
1C0001
1P0001
111111
