111111111111111111
1000000000000000E1
100000000000000001
10C000000100000001
1000000000000000C1
100000000000000001
1P0000000000000001
111111111111111111
