111111
10C0E1
1C0001
10C001
1P00C1
111111

